#######
#o@@@@#
#@@@@##
#>@@@v#
#v@@@@#
#@@@@##
#@@@@x#
#######